12 17
4 4 4 4 4 4 4 4 4 4 4 4 1 1 1 1 0 1 1 0 
4 4 4 4 4 4 4 4 4 4 4 4 1 1 1 1 0 1 0 0 
4 4 4 4 4 4 4 4 4 4 4 4 1 1 1 1 0 1 0 0 
4 1 1 4 4 2 2 4 2 4 2 2 1 1 1 1 0 1 0 0 
1 1 1 1 2 2 2 2 2 2 2 2 1 1 1 1 0 1 0 0 
1 1 1 1 2 2 2 2 2 2 2 2 1 1 1 1 0 1 0 0 
1 1 1 1 2 2 2 2 2 2 2 2 1 1 1 1 0 1 0 0 
1 4 4 1 2 5 5 2 0 5 0 0 1 1 1 1 0 1 0 0 
4 4 4 4 5 5 5 5 5 5 5 5 1 1 1 1 0 1 0 0 
4 4 4 4 5 8 8 5 0 4 0 0 1 1 1 1 0 1 0 0 
4 4 4 4 8 8 8 8 8 8 8 8 1 1 1 1 0 1 0 0 
4 4 4 4 8 8 8 8 8 8 8 8 1 1 1 1 0 1 0 1 
4 4 4 4 4 4 4 4 4 4 4 4 1 1 1 1 0 0 1 0 
4 4 4 4 4 4 4 4 4 4 4 4 1 1 1 1 0 0 0 0 
4 4 4 4 4 4 4 4 4 4 4 4 1 1 1 1 0 0 0 0 
4 1 1 4 4 2 2 4 2 2 2 2 1 1 1 1 0 0 0 0 
1 1 1 1 2 2 2 2 2 2 2 2 1 0.6 1 1 0 0 0 0 
1 1 1 1 2 2 2 2 2 2 2 2 0.6 1 1 1 0 0 0 0 
1 1 1 1 2 2 2 2 2 2 2 2 1 1 1 1 0 0 0 0 
1 4 4 1 2 5 5 2 0 0 0 0 1 1 1 1 0 0 0 0 
4 4 4 4 5 5 5 5 5 5 5 5 1 1 1 1 0 0 0 0 
4 4 4 4 5 8 8 5 0 0 0 0 1 1 1 1 0 0 0 0 
4 4 4 4 8 8 8 8 8 8 8 8 1 1 1 1 0 0 0 0 
4 4 4 4 8 8 8 8 8 8 8 8 1 1 1 1 0 0 0 1 
4 4 4 4 4 4 4 4 4 4 4 4 1 1 1 1 0 0 1 0 
4 4 4 4 4 4 4 4 4 4 4 4 1 1 1 1 0 0 0 0 
4 4 4 4 4 4 4 4 4 4 4 4 1 1 1 1 0 0 0 0 
4 1 1 4 4 2 2 4 2 2 2 2 1 1 1 1 0 0 0 0 
1 1 1 1 2 2 2 2 2 2 2 2 1 1 0.6 1 0 0 0 0 
3 3 3 3 4 4 4 4 4 4 4 4 1 1 1 1 1 1 1 1 
1 1 1 1 2 2 2 2 2 2 2 2 1 1 1 1 0 0 0 0 
1 4 4 1 2 5 5 2 0 0 0 0 1 1 1 1 0 0 0 0 
4 4 4 4 5 5 5 5 5 5 5 5 1 1 1 1 0 0 0 0 
4 4 4 4 5 8 8 5 0 0 0 0 1 1 1 1 0 0 0 0 
4 4 4 4 8 8 8 8 8 8 8 8 1 1 1 1 0 0 0 0 
4 4 4 4 8 8 8 8 8 8 8 8 1 1 1 1 0 0 0 1 
4 4 4 4 4 4 4 4 4 4 4 4 1 1 1 1 0 0 1 0 
4 4 4 4 4 4 4 4 4 4 4 4 1 1 1 1 0 0 0 0 
4 4 4 4 4 4 4 4 4 4 4 4 1 1 1 1 0 0 0 0 
4 1 1 4 4 2 2 4 2 2 2 2 1 1 1 1 0 0 0 0 
1 1 1 1 2 2 2 2 2 2 2 2 1 1 1 1 0 0 0 0 
1 1 1 1 2 2 2 2 2 2 2 2 1 1 1 1 0 0 0 0 
1 1 1 1 2 2 2 2 2 2 2 2 1 1 1 1 0 0 0 0 
1 4 4 1 2 5 5 2 0 0 0 0 1 1 1 1 0 0 0 0 
4 4 4 4 5 5 5 5 5 5 5 5 1 1 1 1 0 0 0 0 
4 4 4 4 5 4 4 5 0 0 0 0 1 1 1 1 0 0 0 0 
4 4 4 4 4 4 4 4 4 4 4 4 1 1 1 1 0 0 0 0 
4 4 4 4 8 8 8 8 8 8 8 8 1 1 1 1 0 0 0 1 
4 4 4 4 4 4 4 4 4 4 4 4 1 1 1 1 0 0 1 0 
4 4 4 4 4 4 4 4 4 4 4 4 1 1 1 1 0 0 0 0 
4 4 4 4 4 4 4 4 4 4 4 4 1 1 1 1 0 0 0 0 
4 1 1 4 4 2 2 4 2 2 2 2 1 1 1 1 0 0 0 0 
1 1 1 1 2 2 2 2 2 2 2 2 1 1 1 1 0 0 0 0 
1 1 1 1 2 2 2 2 2 2 2 2 1 1 1 1 0 0 0 0 
1 1 1 1 2 2 2 2 2 2 2 2 1 1 1 1 0 0 0 0 
1 4 4 1 2 5 5 2 0 0 0 0 1 1 1 1 0 0 0 0 
4 4 4 4 5 5 5 5 5 5 5 5 1 1 1 1 0 0 0 0 
4 4 4 4 5 5 4 5 0 0 0 0 1 1 1 1 0 0 0 0 
4 4 4 4 5 5 4 4 4 4 4 4 1 1 1 1 0 0 0 0 
4 4 4 4 8 8 8 8 8 8 8 8 1 1 1 1 0 0 0 1 
4 4 4 4 4 4 4 4 4 4 4 4 1 1 1 1 0 0 1 0 
4 4 4 4 4 4 4 4 4 4 4 4 1 1 1 1 0 0 0 0 
4 4 4 4 4 4 4 4 4 4 4 4 1 1 1 1 0 0 0 0 
4 1 1 4 4 2 2 4 2 2 2 2 1 1 1 1 0 0 0 0 
1 1 1 1 2 2 2 2 2 2 2 2 1 1 1 1 0 0 0 0 
1 1 1 1 2 2 2 2 2 2 2 2 1 1 1 1 0 0 0 0 
1 1 1 1 2 2 2 2 2 2 2 2 1 1 1 1 0 0 0 0 
1 4 4 1 2 5 5 2 0 0 0 0 1 1 1 1 0 0 0 0 
4 4 4 4 5 5 5 5 5 5 5 5 1 1 1 1 0 0 0 0 
4 4 4 4 5 5 5 5 0 0 0 0 1 1 1 1 0 0 0 0 
4 4 4 4 5 5 5 5 5 5 5 5 1 1 1 1 0 0 0 0 
4 4 4 4 8 8 8 8 8 8 8 8 1 1 1 1 0 0 0 1 
4 4 4 4 4 4 4 4 4 4 4 4 1 1 1 1 0 0 1 0 
4 4 4 4 4 4 4 4 4 4 4 4 1 1 1 1 0 0 0 0 
4 4 4 4 4 4 4 4 4 4 4 4 1 1 1 1 0 0 0 0 
4 1 1 4 4 2 2 4 2 2 2 2 1 1 1 1 0 0 0 0 
1 1 1 1 2 2 2 2 2 2 2 2 1 1 1 1 0 0 0 0 
1 1 1 1 2 2 2 2 2 2 2 2 1 1 1 1 0 0 0 0 
1 1 1 1 2 2 2 2 2 2 2 2 1 1 1 1 0 0 0 0 
1 4 4 1 2 5 5 2 0 0 0 0 1 1 1 1 0 0 0 0 
4 4 4 4 5 5 5 5 5 5 5 5 1 1 1 1 0 0 0 0 
4 4 4 4 8 8 8 8 3 3 3 3 1 1 1 1 0 0 0 0 
4 4 4 4 5 5 5 5 5 5 5 5 1 1 1 1 0 0 0 0 
4 4 4 4 8 8 8 8 8 8 8 8 1 1 1 1 0 0 0 1 
4 4 4 4 4 4 4 4 4 4 4 4 1 1 1 1 0 0 1 0 
4 4 4 4 4 4 4 4 4 4 4 4 1 1 1 1 0 0 0 0 
4 4 4 4 4 4 4 4 4 4 4 4 1 1 1 1 0 0 0 0 
4 1 1 4 4 2 2 4 2 2 2 2 1 1 1 1 0 0 0 0 
1 1 1 1 2 2 2 2 2 2 2 2 1 1 1 1 0 0 0 0 
1 1 1 1 2 2 2 2 2 2 2 2 1 1 1 1 0 0 0 0 
1 1 1 1 2 2 2 2 2 2 2 2 1 1 1 1 0 0 0 0 
1 4 4 1 2 5 5 2 0 0 0 0 1 1 1 1 0 0 0 0 
4 4 4 4 5 5 5 5 5 5 5 5 1 1 1 1 0 0 0 0 
4 4 4 4 8 8 8 8 3 3 3 3 1 1 1 1 0 0 0 0 
4 4 4 4 5 5 5 5 5 5 5 5 1 1 1 1 0 0 0 0 
4 4 4 4 8 8 8 8 8 8 8 8 1 1 1 1 0 0 0 1 
1 1 4 4 2 2 4 4 2 2 4 2 1 1 1 1 0 0 1 0 
1 1 4 4 2 2 4 4 2 2 2 2 1 1 1 1 0 0 0 0 
1 1 4 4 2 2 4 4 2 2 2 2 1 1 1 1 0 0 0 0 
1 1 1 4 2 2 2 4 2 2 2 2 1 1 1 1 0 0 0 0 
1 1 1 1 2 2 2 2 2 2 2 2 1 1 1 1 0 0 0 0 
1 1 1 1 2 2 2 2 2 2 2 2 1 1 1 1 0 0 0 0 
1 1 1 1 2 2 2 2 2 2 2 2 1 1 1 1 0 0 0 0 
1 4 4 1 2 5 5 2 0 0 0 0 1 1 1 1 0 0 0 0 
4 4 4 4 5 5 5 5 5 5 5 5 1 1 1 1 0 0 0 0 
4 4 4 4 8 8 8 8 3 3 3 3 1 1 1 1 0 0 0 0 
4 4 4 4 5 5 5 5 5 5 5 5 1 1 1 1 0 0 0 0 
4 4 4 4 8 8 8 8 8 8 8 8 1 1 1 1 0 0 0 1 
1 1 1 1 2 2 2 2 2 2 2 2 1 1 1 1 0 0 1 0 
1 1 1 1 2 2 2 2 2 2 2 2 1 0.6 1 1 0 0 0 0 
1 1 1 1 2 2 2 2 2 2 2 2 0.6 1 1 1 0 0 0 0 
1 1 1 1 2 2 2 2 2 2 2 2 1 1 1 1 0 0 0 0 
1 1 1 1 2 2 2 2 2 2 2 2 1 1 1 1 0 0 0 0 
1 1 1 1 2 2 2 2 2 2 2 2 1 1 1 1 0 0 0 0 
1 1 1 1 2 2 2 2 2 2 2 2 1 1 1 1 0 0 0 0 
1 4 4 1 2 5 5 2 0 0 0 0 1 1 1 1 0 0 0 0 
4 4 4 4 5 5 5 5 5 5 5 5 1 1 1 1 0 0 0 0 
4 4 4 4 8 8 8 8 3 3 3 3 1 1 1 1 0 0 0 0 
4 4 4 4 5 5 5 5 5 5 5 5 1 1 1 1 0 0 0 0 
4 4 4 4 8 8 8 8 8 8 8 8 1 1 1 1 0 0 0 1 
1 1 1 1 2 2 2 2 2 2 2 2 1 1 1 1 0 0 1 0 
1 1 1 1 2 2 2 2 2 2 2 2 1 1 0.6 1 0 0 0 0 
3 3 3 3 4 4 4 4 4 4 4 4 1 1 1 1 1 1 1 1 
1 1 1 1 2 2 2 2 2 2 2 2 1 1 1 1 0 0 0 0 
1 1 1 1 2 2 2 2 2 2 2 2 1 1 1 1 0 0 0 0 
1 1 1 1 2 2 2 2 2 2 2 2 1 1 1 1 0 0 0 0 
1 1 1 1 2 2 2 2 2 2 2 2 1 1 1 1 0 0 0 0 
1 4 4 1 2 5 5 2 0 0 0 0 1 1 1 1 0 0 0 0 
4 4 4 4 5 5 5 5 5 5 5 5 1 1 1 1 0 0 0 0 
4 4 4 4 8 8 8 8 3 3 3 3 1 1 1 1 0 0 0 0 
4 4 4 4 5 5 5 5 5 5 5 5 1 1 1 1 0 0 0 0 
4 4 4 4 8 8 8 8 8 8 8 8 1 1 1 1 0 0 0 1 
1 1 1 1 2 2 2 2 2 2 2 2 0.06 0.0705882 1 1 0 0 1 0 
1 1 1 1 2 2 2 2 2 2 2 2 0.0705882 0.06 1 1 0 0 0 0 
1 1 1 1 2 2 2 2 2 2 2 2 0.06 0.0705882 1 1 0 0 0 0 
1 1 1 1 2 2 2 2 2 2 2 2 0.0705882 0.06 1 1 0 0 0 0 
1 1 1 1 2 2 2 2 2 2 2 2 0.06 0.0705882 1 1 0 0 0 0 
1 1 1 1 2 2 2 2 2 2 2 2 0.0705882 1 1 1 0 0 0 0 
1 1 1 1 2 2 2 2 2 2 2 2 1 1 1 1 0 0 0 0 
1 4 4 1 2 5 5 2 0 0 0 0 1 1 1 1 0 0 0 0 
4 4 4 4 5 5 5 5 5 5 5 5 1 1 1 1 0 0 0 0 
4 4 4 4 8 8 8 8 3 3 3 3 1 1 1 1 0 0 0 0 
4 4 4 4 5 5 5 5 5 5 5 5 1 1 1 1 0 0 0 0 
4 4 4 4 8 8 8 8 8 8 8 8 1 1 1 1 0 0 0 1 
21 21 21 21 6 6 6 6 6 6 6 6 1 1 1 1 1 1 1 1 
18 18 18 18 6 6 6 6 6 6 6 6 1 0.4 0.4 1 1 1 0 0 
21 21 21 21 6 6 6 6 6 6 6 6 1 1 1 1 1 1 1 1 
18 18 18 18 6 6 6 6 6 6 6 6 1 0.4 0.4 1 1 1 0 0 
21 21 21 21 6 6 6 6 6 6 6 6 1 1 1 1 1 1 1 1 
18 18 18 18 6 6 6 6 6 6 6 6 1 1 1 1 1 1 0 1 
9 4 1 1 7 7 2 2 0 0 0 0 1 1 1 1 0 0 0 0 
4 4 4 1 7 7 5 2 0 0 0 0 1 1 1 1 0 0 0 0 
4 4 4 4 7 7 5 5 0 0 0 0 1 1 1 1 0 0 0 0 
4 4 4 4 7 5 5 5 0 0 0 0 1 1 1 1 0 0 0 0 
4 4 4 4 5 5 5 5 5 5 5 5 1 1 1 1 0 0 0 0 
4 4 4 4 5 7 8 5 0 0 0 7 1 1 1 1 0 0 0 1 
17 17 17 17 7 7 7 7 7 7 7 7 1 1 1 1 0 0 1 0 
17 17 17 17 7 7 7 7 7 7 7 7 1 1 1 1 0 0 0 0 
17 17 17 17 7 7 7 7 7 7 7 7 1 1 1 1 0 0 0 0 
17 17 17 17 7 7 7 7 7 7 7 7 1 1 1 1 0 0 0 0 
17 17 15 17 7 7 7 7 7 7 7 7 1 1 1 1 0 0 0 0 
17 9 9 15 7 7 7 7 7 7 7 7 1 1 1 1 0 0 0 0 
9 4 4 9 7 7 7 7 7 7 7 7 1 1 1 1 0 0 0 0 
4 4 4 4 7 7 7 7 7 7 7 7 1 1 1 1 0 0 0 0 
4 4 4 4 7 7 7 7 7 7 7 7 1 1 1 1 0 0 0 0 
4 4 4 4 7 5 5 7 7 7 7 7 1 1 1 1 0 0 0 0 
4 4 4 4 5 5 5 5 7 7 7 7 1 1 1 1 0 0 0 0 
4 4 4 4 5 7 7 5 7 7 7 7 1 1 1 1 0 0 0 1 
23 23 17 17 6 6 7 7 7 7 7 7 1 1 1 1 0 0 1 0 
23 23 17 17 6 6 7 7 7 7 7 7 1 1 1 1 0 0 0 0 
23 17 17 17 6 5 7 7 7 7 7 7 1 1 1 1 0 0 0 0 
17 17 17 17 5 5 7 7 7 7 7 7 1 1 1 1 0 0 0 0 
17 15 17 17 5 5 7 7 7 7 7 7 1 1 1 1 0 0 0 0 
15 9 9 17 5 5 7 7 7 7 7 7 1 1 1 1 0 0 0 0 
9 4 4 9 5 5 7 7 7 7 7 7 1 1 1 1 0 0 0 0 
4 4 4 4 5 5 7 7 7 7 7 7 1 1 1 1 0 0 0 0 
4 4 4 4 5 5 7 7 7 7 7 7 1 1 1 1 0 0 0 0 
4 4 4 4 5 5 5 7 7 7 7 7 1 1 1 1 0 0 0 0 
4 4 4 4 5 5 5 5 7 7 7 7 1 1 1 1 0 0 0 0 
4 4 4 4 5 7 7 5 7 7 7 7 1 1 1 1 0 0 0 1 
23 23 23 23 6 6 6 6 6 6 6 6 1 1 1 1 0 0 1 0 
23 23 23 23 6 6 6 6 6 6 6 6 1 1 1 1 0 0 0 0 
23 17 17 23 5 5 5 5 5 5 5 5 1 1 1 1 0 0 0 0 
17 17 17 17 5 5 5 5 5 5 5 5 1 1 1 1 0 0 0 0 
17 17 15 17 5 5 5 5 5 5 5 5 1 1 1 1 0 0 0 0 
17 9 9 15 5 5 5 5 5 5 5 5 1 1 1 1 0 0 0 0 
9 4 4 9 5 5 5 5 5 5 5 5 1 1 1 1 0 0 0 0 
4 4 4 4 5 5 5 5 7 7 7 7 1 1 1 1 0 0 0 0 
4 4 4 4 5 5 5 5 7 7 7 7 1 1 1 1 0 0 0 0 
4 4 4 4 5 5 5 5 7 7 7 7 1 1 1 1 0 0 0 0 
4 4 4 4 5 5 5 5 7 7 7 7 1 1 1 1 0 0 0 0 
4 4 4 4 5 7 7 5 7 7 7 7 1 1 1 1 0 0 0 1 
23 23 23 23 6 6 6 6 6 6 6 6 1 1 1 1 1 0 1 0 
23 23 23 23 6 6 6 6 6 6 6 6 1 1 1 1 1 0 0 0 
23 17 17 23 7 7 5 5 7 7 7 7 1 1 1 1 1 0 0 0 
17 17 17 17 7 7 5 5 7 7 7 7 1 1 1 1 1 0 0 0 
17 15 17 17 7 7 5 5 7 7 7 7 1 1 1 1 1 0 0 0 
15 9 9 17 7 7 5 5 7 7 7 7 1 1 1 1 1 0 0 0 
9 4 4 9 7 7 5 5 7 7 7 7 1 1 1 1 1 0 0 0 
4 4 4 4 7 7 5 5 7 7 7 7 1 1 1 1 1 0 0 0 
4 4 4 4 7 7 5 5 7 7 7 7 1 1 1 1 1 0 0 0 
4 4 4 4 7 7 5 5 7 7 7 7 1 1 1 1 1 0 0 0 
4 4 4 4 7 7 5 5 7 7 7 7 1 1 1 1 1 0 0 0 
4 4 4 4 7 7 7 5 7 7 7 7 1 1 1 1 1 0 0 1 
