10 10
0 0 0 0 2 2 2 2 2
0 0 0 0 2 2 2 2 2
2 0 0 2 5 5 5 5 5
0 0 0 0 5 5 5 5 5
0 0 0 0 5 5 5 5 5
0 0 0 0 5 5 5 5 5
0 3 3 0 7 7 7 7 7
3 3 3 3 7 7 7 7 7
3 6 6 3 4 4 4 0 0
6 6 6 6 8 8 4 0 8
0 0 0 0 2 2 2 2 2
0 0 0 0 2 2 2 2 2
2 0 0 2 5 5 5 5 5
0 0 0 0 5 5 5 5 5
0 0 0 0 8 4 4 4 4
0 0 0 0 4 4 4 4 4
0 0 3 0 4 0 0 0 0
7 7 3 3 7 7 7 6 7
7 7 3 3 4 0 0 0 0
7 7 3 3 4 0 0 0 4
0 0 0 0 2 2 2 2 2
0 0 0 0 2 2 2 2 2
2 0 0 2 5 5 5 5 5
0 0 0 0 5 5 5 5 5
0 0 0 0 4 4 4 4 4
13 7 7 7 4 0 6 6 0
7 7 7 7 4 0 6 0 0
13 13 7 7 7 7 7 7 7
7 7 7 7 4 0 0 0 0
7 7 7 7 4 0 0 0 4
0 0 2 2 5 5 5 5 5
0 0 2 2 5 5 5 5 5
0 0 0 2 5 5 5 5 5
0 0 0 0 5 5 5 5 5
0 7 0 0 7 5 5 5 5
13 13 13 13 7 6 6 6 0
13 13 13 13 7 7 6 7 7
13 13 13 13 7 3 7 7 7
13 16 13 13 1 0 6 0 0
16 16 13 13 1 0 6 0 1
0 0 0 0 4 4 4 4 4
0 0 0 0 4 4 4 4 4
0 0 0 0 4 4 4 4 4
0 0 0 0 5 5 5 5 5
0 7 7 0 7 7 7 7 7
7 7 7 7 7 7 7 7 7
13 13 13 13 7 7 7 6 3
11 11 11 11 3 7 7 7 7
13 16 16 13 1 0 0 3 0
16 16 16 16 1 0 0 0 1
0 0 0 0 8 4 4 4 4
0 0 0 0 4 4 4 4 4
0 0 0 0 8 4 4 4 4
0 0 0 0 5 5 5 5 5
0 0 7 0 7 5 5 5 5
13 13 7 7 7 7 7 6 7
13 13 13 13 7 7 7 6 7
13 13 13 13 7 7 3 7 7
13 13 16 13 1 0 0 0 0
13 13 16 16 1 0 0 0 1
0 0 0 0 4 4 4 4 4
0 0 0 0 4 4 4 4 4
0 0 0 0 4 4 4 4 4
0 0 0 0 5 5 5 5 5
0 0 0 0 4 4 4 4 4
13 13 13 13 7 7 7 6 7
13 13 13 13 7 7 7 7 7
13 13 13 13 7 7 7 7 7
13 13 13 13 7 7 7 7 7
13 13 13 13 7 3 7 7 7
0 0 0 0 4 4 4 4 4
0 0 0 0 8 4 4 4 4
0 0 0 0 4 4 4 4 4
0 0 0 0 5 5 5 5 5
0 0 0 0 4 4 4 4 4
7 7 13 13 7 7 7 6 7
13 13 13 13 7 7 7 6 7
13 13 13 13 7 3 7 7 7
13 13 13 13 7 7 7 7 3
11 11 11 11 3 7 7 7 7
0 0 0 0 4 4 4 4 4
0 0 0 0 4 4 4 4 4
0 0 0 0 4 4 4 4 4
4 4 0 0 7 7 7 6 6
0 0 0 0 4 4 4 4 4
7 7 7 7 7 7 7 6 7
13 13 13 13 7 7 7 6 3
11 11 11 11 3 7 7 7 7
13 13 13 13 7 7 7 3 7
13 13 13 13 7 7 3 7 7
0 0 0 0 8 4 4 4 4
0 0 0 0 4 4 4 4 4
0 0 0 0 4 4 4 4 4
4 4 4 4 7 7 7 6 7
4 7 7 4 7 7 6 7 7
7 7 7 7 7 7 7 7 7
13 13 13 13 7 7 7 6 7
13 13 13 13 7 7 3 7 7
13 13 13 13 7 7 7 7 7
13 13 13 13 7 7 7 7 7
