10 10
0 0 0 0 0 0 0 0 2 2 2 2 2 1 1 1 1
0 0 0 0 0 0 0 0 2 2 2 2 2 1 0.75 0.75 1
2 0 0 2 0 0 0 0 5 5 5 5 5 1 1 1 1
0 0 0 0 0 0 0 0 5 5 5 5 5 1 1 1 1
0 0 0 0 0 0 0 0 5 5 5 5 5 1 1 1 1
0 0 0 0 0 0 0 0 5 5 5 5 5 1 1 1 1
0 3 3 0 0 0 0 0 7 7 7 7 7 1 1 1 1
3 3 3 3 0 0 0 0 7 7 7 7 7 1 1 1 1
3 6 6 3 0 0 0 0 4 4 4 0 0 1 1 1 1
6 6 6 6 0 0 0 0 8 8 4 0 8 1 1 1 1
0 0 0 0 0 0 0 0 2 2 2 2 2 1 1 1 1
0 0 0 0 0 0 0 0 2 2 2 2 2 1 0.75 0.75 1
2 0 0 2 0 0 0 0 5 5 5 5 5 1 1 1 1
0 0 0 0 0 0 0 0 5 5 5 5 5 1 1 1 1
0 0 0 0 0 0 0 0 8 4 4 4 4 1 0.214286 1 1
0 0 0 0 0 0 0 0 4 4 4 4 4 0.214286 0.214286 1 1
0 0 3 0 0 0 0 0 4 0 0 0 0 0.214286 0.214286 1 1
7 7 3 3 0 0 0 0 7 7 7 6 7 1 1 1 1
7 7 3 3 0 0 0 0 4 0 0 0 0 1 1 1 1
7 7 3 3 0 0 0 0 4 0 0 0 4 1 1 1 1
0 0 0 0 0 0 0 0 2 2 2 2 2 0.75 0.75 1 1
0 0 0 0 0 0 0 0 2 2 2 2 2 0.75 0.75 0.75 1
2 0 0 2 0 0 0 0 5 5 5 5 5 1 1 1 1
0 0 0 0 0 0 0 0 5 5 5 5 5 1 1 1 1
0 0 0 0 0 0 0 0 4 4 4 4 4 1 0.115385 0.214286 1
13 7 7 7 0 0 0 0 4 0 6 6 0 1 0.25 1 1
7 7 7 7 0 0 0 0 4 0 6 0 0 0.25 0.25 1 1
13 13 7 7 0 0 0 0 7 7 7 7 7 1 1 1 1
7 7 7 7 0 0 0 0 4 0 0 0 0 0.25 0.25 1 1
7 7 7 7 0 0 0 0 4 0 0 0 4 0.25 0.25 1 1
0 0 2 2 0 0 0 0 5 5 5 5 5 1 1 1 1
0 0 2 2 0 0 0 0 5 5 5 5 5 1 1 1 1
0 0 0 2 0 0 0 0 5 5 5 5 5 1 1 1 1
0 0 0 0 0 0 0 0 5 5 5 5 5 1 1 1 1
0 7 0 0 0 0 0 0 7 5 5 5 5 1 1 0.115385 1
13 13 13 13 0 0 0 0 7 6 6 6 0 1 1 1 1
13 13 13 13 0 0 0 0 7 7 6 7 7 1 1 1 1
13 13 13 13 0 0 0 0 7 3 7 7 7 1 1 1 1
13 16 13 13 0 0 0 0 1 0 6 0 0 1 1 1 1
16 16 13 13 0 0 0 0 1 0 6 0 1 1 1 1 1
0 0 0 0 0 0 0 0 4 4 4 4 4 1 1 1 1
0 0 0 0 0 0 0 0 4 4 4 4 4 1 1 1 1
0 0 0 0 0 0 0 0 4 4 4 4 4 1 1 1 1
0 0 0 0 0 0 0 0 5 5 5 5 5 1 1 1 1
0 7 7 0 0 0 0 0 7 7 7 7 7 1 1 1 1
7 7 7 7 0 0 0 0 7 7 7 7 7 1 0.25 0.25 1
13 13 13 13 0 0 0 0 7 7 7 6 3 1 1 1 1
11 11 11 11 0 0 0 0 3 7 7 7 7 0.75 0.75 0.75 1
13 16 16 13 0 0 0 0 1 0 0 3 0 1 1 1 1
16 16 16 16 0 0 0 0 1 0 0 0 1 1 1 1 1
0 0 0 0 0 0 0 0 8 4 4 4 4 1 1 1 1
0 0 0 0 0 0 0 0 4 4 4 4 4 1 1 1 1
0 0 0 0 0 0 0 0 8 4 4 4 4 1 1 1 1
0 0 0 0 0 0 0 0 5 5 5 5 5 1 1 1 1
0 0 7 0 0 0 0 0 7 5 5 5 5 1 0.115385 1 1
13 13 7 7 0 0 0 0 7 7 7 6 7 1 1 0.25 1
13 13 13 13 0 0 0 0 7 7 7 6 7 1 1 1 1
13 13 13 13 0 0 0 0 7 7 3 7 7 1 1 1 1
13 13 16 13 0 0 0 0 1 0 0 0 0 1 1 1 1
13 13 16 16 0 0 0 0 1 0 0 0 1 1 1 1 1
0 0 0 0 0 0 0 0 4 4 4 4 4 1 1 1 1
0 0 0 0 0 0 0 0 4 4 4 4 4 1 1 1 1
0 0 0 0 0 0 0 0 4 4 4 4 4 1 1 1 1
0 0 0 0 0 0 0 0 5 5 5 5 5 1 1 1 1
0 0 0 0 0 0 0 0 4 4 4 4 4 1 0.115385 0.115385 1
13 13 13 13 0 0 0 0 7 7 7 6 7 1 1 1 1
13 13 13 13 0 0 0 0 7 7 7 7 7 1 1 1 1
13 13 13 13 0 0 0 0 7 7 7 7 7 1 1 1 1
13 13 13 13 0 0 0 0 7 7 7 7 7 1 1 1 1
13 13 13 13 0 0 0 0 7 3 7 7 7 1 1 1 1
0 0 0 0 0 0 0 0 4 4 4 4 4 1 1 1 1
0 0 0 0 0 0 0 0 8 4 4 4 4 1 1 1 1
0 0 0 0 0 0 0 0 4 4 4 4 4 1 1 1 1
0 0 0 0 0 0 0 0 5 5 5 5 5 1 1 1 1
0 0 0 0 0 0 0 0 4 4 4 4 4 1 0.214286 0.115385 1
7 7 13 13 0 0 0 0 7 7 7 6 7 1 0.25 1 1
13 13 13 13 0 0 0 0 7 7 7 6 7 1 1 1 1
13 13 13 13 0 0 0 0 7 3 7 7 7 1 1 1 1
13 13 13 13 0 0 0 0 7 7 7 7 3 1 1 1 1
11 11 11 11 0 0 0 0 3 7 7 7 7 0.75 0.75 1 1
0 0 0 0 0 0 0 0 4 4 4 4 4 1 1 1 1
0 0 0 0 0 0 0 0 4 4 4 4 4 1 1 1 1
0 0 0 0 0 0 0 0 4 4 4 4 4 1 0.375 1 1
4 4 0 0 0 0 0 0 7 7 7 6 6 1 1 1 1
0 0 0 0 0 0 0 0 4 4 4 4 4 0.375 0.214286 0.214286 1
7 7 7 7 0 0 0 0 7 7 7 6 7 1 0.25 0.25 1
13 13 13 13 0 0 0 0 7 7 7 6 3 1 1 1 1
11 11 11 11 0 0 0 0 3 7 7 7 7 0.75 0.75 0.75 1
13 13 13 13 0 0 0 0 7 7 7 3 7 1 1 1 1
13 13 13 13 0 0 0 0 7 7 3 7 7 1 1 1 1
0 0 0 0 0 0 0 0 8 4 4 4 4 1 1 1 1
0 0 0 0 0 0 0 0 4 4 4 4 4 1 1 1 1
0 0 0 0 0 0 0 0 4 4 4 4 4 1 0.375 0.375 1
4 4 4 4 0 0 0 0 7 7 7 6 7 1 1 1 1
4 7 7 4 0 0 0 0 7 7 6 7 7 1 1 1 1
7 7 7 7 0 0 0 0 7 7 7 7 7 1 0.25 0.25 1
13 13 13 13 0 0 0 0 7 7 7 6 7 1 1 1 1
13 13 13 13 0 0 0 0 7 7 3 7 7 1 1 1 1
13 13 13 13 0 0 0 0 7 7 7 7 7 1 1 1 1
13 13 13 13 0 0 0 0 7 7 7 7 7 1 1 1 1
